*************
*AAAAA*4   4*
*AAAAA*     *
* P   D1111MC*
*HHHHH*     *
*HHHHH*4   4*
**D**********
*     *
*     *
*     *
*  G  *
*     *  
*******